64 // Columns
62 // Rows
000 001 002 001 002 001 002 001 002 001 002 001 002 001 002 001 002 001 002 001 002 001 002 001 002 001 002 001 002 001 002 001 002 001 002 001 002 001 002 001 002 001 002 001 002 001 002 001 002 001 002 001 002 001 002 001 002 001 002 001 002 001 002 003
008 009 010 009 010 009 010 009 010 009 010 009 010 009 010 009 010 009 010 009 010 009 010 009 010 009 010 009 010 009 010 009 010 009 010 009 010 009 010 009 010 009 010 009 010 009 010 009 010 009 010 009 010 009 010 009 010 009 010 009 010 009 010 011
008 024 025 025 025 025 025 025 025 025 025 025 025 025 025 025 025 025 025 025 025 025 025 025 025 025 025 025 025 025 025 025 025 025 025 025 025 025 025 025 025 025 025 025 025 025 025 025 025 025 025 025 025 025 025 025 025 025 025 025 025 025 026 011
008 032 033 033 033 033 033 033 033 033 033 033 033 033 033 033 033 033 033 033 033 033 033 033 033 033 033 033 033 033 033 033 033 033 033 033 033 033 033 033 033 033 033 033 033 033 033 033 033 033 033 033 033 033 033 033 033 033 033 033 033 033 034 011
008 032 033 033 033 033 033 033 033 033 033 033 033 033 033 033 033 033 033 033 033 033 033 033 033 033 033 033 033 033 033 033 033 033 033 033 033 033 033 033 033 033 033 033 033 033 033 033 033 033 033 033 033 033 033 033 033 033 033 033 033 033 034 011
008 032 033 033 033 033 033 033 033 033 033 033 033 033 033 033 033 033 033 033 033 033 033 033 033 033 033 033 033 033 033 033 033 033 033 033 033 033 033 033 033 033 033 033 033 033 033 033 033 033 033 033 033 033 033 033 033 033 033 033 033 033 034 011
008 032 033 033 033 033 033 033 033 033 033 033 033 033 033 033 033 033 033 033 033 033 033 033 033 033 033 033 033 033 033 033 033 033 033 033 033 033 033 033 033 033 033 033 033 033 033 033 033 033 033 033 033 033 033 033 033 033 033 033 033 033 034 011
008 032 033 033 033 033 033 033 033 033 033 033 033 033 033 033 033 033 033 033 033 033 033 033 033 033 033 033 033 033 033 033 033 033 033 033 033 033 033 033 033 033 033 033 033 033 033 033 033 033 033 033 033 033 033 033 033 033 033 033 033 033 034 011
008 032 033 033 033 033 033 033 033 033 033 033 033 033 033 033 033 033 033 033 033 033 033 033 033 033 033 033 033 033 033 033 033 033 033 033 033 033 033 033 033 033 033 033 033 033 033 033 033 033 033 033 033 033 033 033 033 033 033 033 033 033 034 011
008 032 033 033 033 033 033 033 033 033 033 033 033 033 033 033 033 033 033 033 033 033 033 033 033 033 033 033 033 033 033 033 033 033 033 033 033 033 033 033 033 033 033 033 033 033 033 033 033 033 033 033 033 033 033 033 033 033 033 033 033 033 034 011
008 032 033 033 033 033 033 033 033 033 033 033 033 033 033 033 033 033 033 033 033 033 033 033 033 033 033 033 033 033 033 033 033 033 033 033 033 033 033 033 033 033 033 033 033 033 033 033 033 033 033 033 033 033 033 033 033 033 033 033 033 033 034 011
008 032 033 033 033 033 033 033 033 033 033 033 033 033 033 033 033 033 033 033 033 033 033 033 033 033 033 033 033 033 033 033 033 033 033 033 033 033 033 033 033 033 033 033 033 033 033 033 033 033 033 033 033 033 033 033 033 033 033 033 033 033 034 011
008 032 033 033 033 033 033 033 033 033 033 033 033 033 033 033 033 033 033 033 033 033 033 033 033 033 033 033 033 033 033 033 033 033 033 033 033 033 033 033 033 033 033 033 033 033 033 033 033 033 033 033 033 033 033 033 033 033 033 033 033 033 034 011
008 032 033 033 033 033 033 033 033 033 033 033 033 033 033 033 033 033 033 033 033 033 033 033 033 033 033 033 033 033 033 033 033 033 033 033 033 033 033 033 033 033 033 033 033 033 033 033 033 033 033 033 033 033 033 033 033 033 033 033 033 033 034 011
008 032 033 033 033 033 033 033 033 033 033 033 033 033 033 033 033 033 033 033 033 033 033 033 033 033 033 033 033 033 033 033 033 033 033 033 033 033 033 033 033 033 033 033 033 033 033 033 033 033 033 033 033 033 033 033 033 033 033 033 033 033 034 011
008 032 033 033 033 033 033 033 033 033 033 033 033 033 033 060 033 033 033 033 033 033 033 033 033 033 033 033 033 033 033 033 033 033 033 033 033 033 033 033 033 033 033 033 033 033 033 033 033 033 033 033 033 033 033 033 033 033 033 033 033 033 034 011
008 032 033 033 033 033 033 033 033 033 033 033 033 033 033 033 033 033 033 033 033 033 033 033 033 033 033 033 033 033 033 033 033 033 033 033 033 033 033 033 033 033 033 033 033 033 033 033 033 033 033 033 033 033 033 033 033 033 033 033 033 033 034 011
008 032 033 033 033 033 033 033 033 033 033 033 033 033 033 033 033 033 033 033 033 033 033 033 033 033 033 033 033 033 033 033 033 033 033 033 033 033 033 033 033 033 033 033 033 033 033 033 033 033 033 033 033 033 033 033 033 033 033 033 033 033 034 011
008 032 033 033 033 033 033 033 033 033 033 033 033 033 033 033 033 033 033 033 033 033 033 033 033 033 033 033 033 033 033 033 033 033 033 033 033 033 033 033 033 033 033 033 033 033 033 033 033 033 033 033 033 033 033 033 033 033 033 033 033 033 034 011
008 032 033 033 033 033 033 033 033 033 033 033 033 033 033 033 033 033 033 033 033 033 033 033 033 033 033 033 033 033 033 033 033 033 033 033 033 033 033 033 033 033 033 033 033 033 033 033 033 033 033 033 033 033 033 033 033 033 033 033 033 033 034 011
008 032 033 033 033 033 033 033 033 033 033 033 033 033 033 033 033 033 033 033 033 033 033 033 033 033 033 033 033 033 033 033 033 033 033 033 033 033 033 033 033 033 033 033 033 033 033 033 033 033 033 033 033 033 033 033 033 033 033 033 033 033 034 011
008 032 033 033 033 033 033 033 033 033 033 033 033 033 033 033 033 033 033 033 033 033 033 033 033 033 033 033 033 033 033 033 033 033 033 033 033 033 033 033 033 033 033 033 033 033 033 033 033 033 033 033 033 033 033 033 033 033 033 033 033 033 034 011
008 032 033 033 033 033 033 033 033 033 033 033 033 033 033 033 033 033 033 033 033 033 033 033 033 033 033 033 033 033 033 033 033 033 033 033 033 033 033 033 033 033 033 033 033 033 033 033 033 033 033 033 033 033 033 033 033 033 033 033 033 033 034 011
027 032 033 033 033 033 033 078 079 033 033 033 033 033 033 033 033 033 033 033 033 033 033 033 033 033 033 033 033 033 033 033 033 033 033 033 033 033 033 033 033 033 033 033 033 033 033 033 033 033 033 033 033 033 033 033 033 033 033 033 033 033 034 011
035 032 033 033 033 033 033 086 087 033 033 033 033 033 033 033 033 033 033 033 033 033 033 033 033 033 033 033 033 033 033 033 033 033 033 033 033 033 033 033 033 033 033 033 033 033 033 033 033 033 033 033 033 033 033 033 033 033 033 033 033 033 034 011
045 046 046 046 046 046 063 086 087 063 055 033 033 033 033 033 033 033 033 033 033 033 033 033 033 033 033 033 033 033 033 033 033 033 033 033 033 033 033 033 033 033 033 033 033 033 033 033 033 033 033 033 033 033 033 033 033 033 033 033 033 033 034 011
007 064 065 065 065 065 065 065 065 066 055 033 033 033 033 033 033 033 033 033 033 033 033 033 033 033 033 033 033 033 033 033 033 033 033 033 033 033 033 033 033 033 033 033 033 033 033 033 033 033 033 033 033 033 033 033 033 033 033 033 033 033 034 011
007 072 073 073 073 073 073 073 073 074 055 033 033 033 033 033 033 033 033 033 033 033 033 033 033 033 033 033 033 033 033 033 033 033 033 033 033 033 033 033 033 033 033 033 033 033 033 033 033 033 033 033 033 033 033 033 033 033 033 033 033 033 034 011
007 072 073 073 073 073 073 073 073 074 055 033 033 033 033 033 033 033 033 033 033 033 033 033 033 033 033 033 033 033 033 033 033 033 033 033 033 033 033 033 033 033 033 033 033 033 033 033 033 033 033 033 033 033 033 033 033 033 033 033 033 033 034 011
007 080 081 073 073 073 073 060 030 031 055 033 033 033 033 033 033 033 033 033 033 033 033 033 033 033 033 033 033 033 033 033 033 033 033 033 033 033 033 033 033 033 033 033 033 033 033 033 033 033 033 033 033 033 033 033 033 033 033 033 033 033 034 011
045 046 063 073 073 060 081 081 038 039 055 033 033 033 033 033 033 033 033 033 033 033 033 033 033 033 033 033 033 033 033 033 033 033 033 033 033 033 033 033 033 033 033 033 033 033 033 033 033 033 033 033 033 033 033 033 033 033 033 033 033 033 034 011
043 032 062 067 068 054 046 046 046 046 063 033 033 033 033 033 033 033 033 033 033 033 033 033 033 033 033 033 033 033 033 033 033 033 033 033 033 033 033 033 033 033 033 033 033 033 033 033 033 033 033 033 033 033 033 033 033 033 033 033 033 033 034 011
008 032 063 063 063 063 033 033 033 033 033 033 033 033 033 033 033 033 033 033 033 033 033 033 033 033 033 033 033 033 033 033 033 033 033 033 033 033 033 033 033 033 033 033 033 033 033 033 033 033 033 033 033 033 033 033 033 033 033 033 033 033 034 011
008 032 033 033 033 033 033 033 033 033 033 033 033 033 033 033 033 033 033 033 033 033 033 033 033 033 033 033 033 033 033 033 033 033 033 033 033 033 033 033 033 033 033 033 033 033 033 033 033 033 033 033 033 033 033 033 033 033 033 033 033 033 034 011
008 032 033 033 033 033 033 033 033 033 033 033 033 033 033 033 033 033 033 033 033 033 033 033 033 033 033 033 033 033 033 033 033 033 033 033 033 033 033 033 033 033 033 033 033 033 033 033 033 033 033 033 033 033 033 033 033 033 033 033 033 033 034 011
008 032 033 033 033 033 033 033 033 033 033 033 033 033 033 033 033 033 033 033 033 033 033 033 033 033 033 033 033 033 033 033 033 033 033 033 033 033 033 033 033 033 033 033 033 033 033 033 033 033 033 033 033 033 033 033 033 033 033 033 033 033 034 011
008 032 033 033 033 033 033 033 033 033 033 033 033 033 033 033 033 033 033 033 033 033 033 033 033 033 033 033 033 033 033 033 033 033 033 033 033 033 033 033 033 033 033 033 033 033 033 033 033 033 033 033 033 033 033 033 033 033 033 033 033 033 034 011
008 032 033 033 033 033 033 033 033 033 033 033 033 033 033 033 033 033 033 033 033 033 033 033 033 033 033 033 033 033 033 033 033 033 033 033 033 033 033 033 033 033 033 033 033 033 033 033 033 033 033 033 033 033 033 033 033 033 033 033 033 033 034 011
008 032 033 033 033 033 033 033 033 033 033 033 033 033 033 033 033 033 033 033 033 033 033 033 033 033 033 033 033 033 033 033 033 033 033 033 033 033 033 033 033 033 033 033 033 033 033 033 033 033 033 033 033 033 033 033 033 033 033 033 033 033 034 011
008 032 033 033 033 033 033 033 033 033 033 033 033 033 033 033 033 033 033 033 033 033 033 033 033 033 033 033 033 033 033 033 033 033 033 033 033 033 033 033 033 033 033 033 033 033 033 033 033 033 033 033 033 033 033 033 033 033 033 033 033 033 034 011
008 032 033 033 033 033 033 033 033 033 033 033 033 033 033 033 033 033 033 033 033 033 033 033 033 033 033 033 033 033 033 033 033 033 033 033 033 033 033 033 033 033 033 033 033 033 033 033 033 033 033 033 033 033 033 033 033 033 033 033 033 033 034 011
008 032 033 033 033 033 033 033 033 033 033 033 033 033 033 033 033 033 033 033 033 033 033 033 033 033 033 033 033 033 033 033 033 033 033 033 033 033 033 033 033 033 033 033 033 033 033 033 033 033 033 033 033 033 033 033 033 033 033 033 033 033 034 011
008 032 033 033 033 033 033 033 033 033 033 033 033 033 033 033 033 033 033 033 033 033 033 033 033 033 033 033 033 033 033 033 033 033 033 033 033 033 033 033 033 033 033 033 033 033 033 033 033 033 033 033 033 033 033 033 033 033 033 033 033 033 034 011
008 032 033 033 033 033 033 033 033 033 033 033 033 033 033 033 033 033 033 033 033 033 033 033 033 033 033 033 033 033 033 033 033 033 033 033 033 033 033 033 033 033 033 033 033 033 033 033 033 033 033 033 033 033 033 033 033 033 033 033 033 033 034 011
008 032 033 033 033 033 033 033 033 033 033 033 033 033 033 033 033 033 033 033 033 033 033 033 033 033 033 033 033 033 033 033 033 033 033 033 033 033 033 033 033 033 033 033 033 033 033 033 033 033 033 033 033 033 033 033 033 033 033 033 033 033 034 011
008 032 033 033 033 033 033 033 033 033 033 033 033 033 033 033 033 033 033 033 033 033 033 033 033 033 033 033 033 033 033 033 033 033 033 033 033 033 033 033 033 033 033 033 033 033 033 033 033 033 033 033 033 033 033 033 033 033 033 033 033 033 034 011
008 032 033 033 033 033 033 033 033 033 033 033 033 033 033 033 033 033 033 033 033 033 033 033 033 033 033 033 033 033 033 033 033 033 033 033 033 033 033 033 033 033 033 033 033 033 033 033 033 033 033 033 033 033 033 033 033 033 033 033 033 033 034 011
008 032 033 033 033 033 033 033 033 033 033 033 033 033 033 033 033 033 033 033 033 033 033 033 033 033 033 033 033 033 033 033 033 033 033 033 033 033 033 033 033 033 033 033 033 033 033 033 033 033 033 033 033 033 033 033 033 033 033 033 033 033 034 011
008 032 033 033 033 033 033 033 033 033 033 033 033 033 033 033 033 033 033 033 033 033 033 033 033 033 033 033 033 033 033 033 033 033 033 033 033 033 033 033 033 033 033 033 033 033 033 033 033 033 033 033 033 033 033 033 033 033 033 033 033 033 034 011
008 032 033 033 033 033 033 033 033 033 033 033 033 033 033 033 033 033 033 033 033 033 033 033 033 033 033 033 033 033 033 033 033 033 033 033 033 033 033 033 033 033 033 033 033 033 033 033 033 033 033 033 033 033 033 033 033 033 033 033 033 033 034 011
008 032 033 033 033 033 033 033 033 033 033 033 033 033 033 033 033 033 033 033 033 033 033 033 033 033 033 033 033 033 033 033 033 033 033 033 033 033 033 033 033 033 033 033 033 033 033 033 033 033 033 033 033 033 033 033 033 033 033 033 033 033 034 011
008 032 033 033 033 033 033 033 033 033 033 033 033 033 033 033 033 033 033 033 033 033 033 033 033 033 033 033 033 033 033 033 033 033 033 033 033 033 033 033 033 033 033 033 033 033 033 033 033 033 033 033 033 033 033 033 033 033 033 033 033 033 034 011
008 032 033 033 033 033 033 033 033 033 033 033 033 033 033 033 033 033 033 033 033 033 033 033 033 033 033 033 033 033 033 033 033 033 033 033 033 033 033 033 033 033 033 033 033 033 033 033 033 033 033 033 033 033 033 033 033 033 033 033 033 033 034 011
008 032 033 033 033 033 033 033 033 033 033 033 033 033 033 033 033 033 033 033 033 033 033 033 033 033 033 033 033 033 033 033 033 033 033 033 033 033 033 033 033 033 033 033 033 033 033 033 033 033 033 033 033 033 033 033 033 033 033 033 033 033 034 011
008 032 033 033 033 033 033 033 033 033 033 033 033 033 033 033 033 033 033 033 033 033 033 033 033 033 033 033 033 033 033 033 033 033 033 033 033 033 033 033 033 033 033 033 033 033 033 033 033 033 033 033 033 033 033 033 033 033 033 033 033 033 034 011
008 032 033 033 033 033 033 033 033 033 033 033 033 033 033 033 033 033 033 033 033 033 033 033 033 033 033 033 033 033 033 033 033 033 033 033 033 033 033 033 033 033 033 033 033 033 033 033 033 033 033 033 033 033 033 033 033 033 033 033 033 033 034 011
008 032 033 033 033 033 033 033 033 033 033 033 033 033 033 033 033 033 033 033 033 033 033 033 033 033 033 033 033 033 033 033 033 033 033 033 033 033 033 033 033 033 033 033 033 033 033 033 033 033 033 033 033 033 033 033 033 033 033 033 033 033 034 011
008 032 033 033 033 033 033 033 033 033 033 033 033 033 033 033 033 033 033 033 033 033 033 033 033 033 033 033 033 033 033 033 033 033 033 033 033 033 033 033 033 033 033 033 033 033 033 033 033 033 033 033 033 033 033 033 033 033 033 033 033 033 034 011
008 032 033 033 033 033 033 033 033 033 033 033 033 033 033 033 033 033 033 033 033 033 033 033 033 033 033 033 033 033 033 033 033 033 033 033 033 033 033 033 033 033 033 033 033 033 033 033 033 033 033 033 033 033 033 033 033 033 033 033 033 033 034 011
008 032 033 033 033 033 033 033 033 033 033 033 033 033 033 033 033 033 033 033 033 033 033 033 033 033 033 033 033 033 033 033 033 033 033 033 033 033 033 033 033 033 033 033 033 033 033 033 033 033 033 033 033 033 033 033 033 033 033 033 033 033 034 011
008 040 041 041 041 041 041 041 041 041 041 041 041 041 041 041 041 041 041 041 041 041 041 041 041 041 041 041 041 041 041 041 041 041 041 041 041 041 041 041 041 041 041 041 041 041 041 041 041 041 041 041 041 041 041 041 041 041 041 041 041 041 042 011
016 017 018 017 018 017 018 017 018 017 018 017 018 017 018 017 018 017 018 017 018 017 018 017 018 017 018 017 018 017 018 017 018 017 018 017 018 017 018 017 018 017 018 017 018 017 018 017 018 017 018 017 018 017 018 017 018 017 018 017 018 017 018 019